##############
#....~~~~~~..#
#....~~~~~~..#
#....######..#
#....#....#..#
#.@.......#..#
##############